alain	aa ll in
ani	aa nn ii
hugui	uu gg ii
humain	uu mm in
humin	uu mm in
humvu	un vv uu
héfeu	ei ff eu
kian	kk yy an
laha	ll aa aa
meuheu	mm eu eu
meuhin	mm eu in
mov	mm oo vv
feuheu	ff eu eu
feuhin	ff eu in
nian	nn yy an
nihin	nn yy in
niho	nn yy au
nihu	nn yy uu
nuou	nn uu ou
oui	ww ii
peuha	pp eu aa
riou	rr yy ou
tahin	tt aa in
vaheu	vv aa eu
veuheu	vv eu eu
veuhin	vv eu in
vihan	vv yy an
viheu	vv yy eu
vihin	vv yy in
vré	vv rr ei
vuhin	vv uu in
véha	vv ei aa
yera	yy rr aa
zaha	zz aa aa
bozo	bb oo zz au
bédin	bb ei dd in
bégé	bb ei jj ei
béhié	bb ei yy ei
béiou	bb ei yy ou
béji	bb ei jj ii
chaman	ch aa mm aa nn
chamba	ch an bb aa
chanmo	ch an mm au
chélou	ch ei ll ou
chéro	ch ei rr au
chéssan	ch ei ss an
chéyeu	ch ei yy eu
chéza	ch ei zz aa
cossin	kk oo ss in
coudou	kk ou dd ou
coufin	kk ou ff in
fopi	ff oo pp ii